"a" = (/obj/effect/turf_decal/caution/white{dir = 8},/obj/effect/decal/cleanable/dirt,/turf/open/floor/iron/shuttle/cargo{dir = 1},/area/shuttle/supply)
"b" = (/obj/machinery/button/door/directional/west{id = "cargoload"; name = "Loading Doors"; pixel_y = 8; pixel_x = 24},/obj/effect/decal/cleanable/dirt,/turf/open/floor/iron/shuttle/cargo{dir = 1},/area/shuttle/supply)
"c" = (/obj/effect/turf_decal/stripes/line{dir = 4},/obj/effect/turf_decal/loading_area/white{dir = 8; pixel_x = -5},/turf/open/floor/iron/shuttle/cargo{dir = 1},/area/shuttle/supply)
"f" = (/obj/effect/decal/cleanable/dirt,/turf/open/floor/iron/shuttle/cargo{dir = 1},/area/shuttle/supply)
"g" = (/obj/effect/decal/cleanable/dirt,/turf/open/floor/iron/dark/diagonal,/area/shuttle/supply)
"j" = (/turf/closed/wall/mineral/titanium/nodiagonal,/area/shuttle/supply)
"k" = (/obj/machinery/power/shuttle_engine/propulsion,/turf/open/floor/plating/airless,/area/shuttle/supply)
"l" = (/obj/effect/turf_decal/box/white/corners{dir = 4},/turf/open/floor/iron/dark/diagonal,/area/shuttle/supply)
"m" = (/turf/open/floor/iron/shuttle/cargo{dir = 1},/area/shuttle/supply)
"o" = (/obj/machinery/power/shuttle_engine/heater,/obj/structure/window/reinforced/plasma/spawner/directional/north,/turf/open/floor/plating/airless,/area/shuttle/supply)
"p" = (/obj/structure/marker_beacon/burgundy,/turf/closed/wall/mineral/titanium,/area/shuttle/supply)
"q" = (/obj/structure/sign/warning/no_smoking/circle/directional/west,/obj/effect/decal/cleanable/dirt,/turf/open/floor/iron/shuttle/cargo{dir = 1},/area/shuttle/supply)
"r" = (/obj/machinery/door/airlock/grunge{name = "Supply Shuttle Airlock"; req_access = list("cargo")},/obj/docking_port/mobile/supply,/turf/open/floor/iron/dark/textured_large,/area/shuttle/supply)
"s" = (/obj/effect/turf_decal/box/white/corners{dir = 4},/obj/effect/decal/cleanable/dirt,/turf/open/floor/iron/dark/diagonal,/area/shuttle/supply)
"t" = (/obj/effect/turf_decal/box/white/corners{dir = 1},/obj/effect/decal/cleanable/dirt,/turf/open/floor/iron/dark/diagonal,/area/shuttle/supply)
"y" = (/obj/effect/spawner/structure/window/reinforced/plasma/plastitanium,/turf/open/floor/plating/airless,/area/shuttle/supply)
"z" = (/obj/effect/turf_decal/box/white/corners{dir = 1},/turf/open/floor/iron/dark/diagonal,/area/shuttle/supply)
"C" = (/obj/structure/marker_beacon/olive,/turf/closed/wall/mineral/titanium,/area/shuttle/supply)
"H" = (/turf/closed/wall/mineral/titanium/spaceship/nodiagonal,/area/shuttle/supply)
"I" = (/obj/effect/turf_decal/box/white/corners,/obj/effect/decal/cleanable/dirt,/turf/open/floor/iron/dark/diagonal,/area/shuttle/supply)
"K" = (/turf/closed/wall/mineral/titanium,/area/shuttle/supply)
"L" = (/obj/structure/marker_beacon/olive,/turf/closed/wall/mineral/titanium/nodiagonal,/area/shuttle/supply)
"O" = (/obj/structure/marker_beacon/burgundy,/turf/closed/wall/mineral/titanium/nodiagonal,/area/shuttle/supply)
"S" = (/obj/machinery/conveyor{dir = 4; id = "cargoload"},/obj/machinery/door/poddoor{id = "cargounload"; name = "Supply Dock Unloading Door"},/turf/open/floor/iron/dark/textured_large,/area/shuttle/supply)
"T" = (/obj/effect/turf_decal/box/white/corners{dir = 8},/obj/effect/decal/cleanable/dirt,/turf/open/floor/iron/dark/diagonal,/area/shuttle/supply)
"W" = (/obj/machinery/button/door/directional/west{id = "cargounload"; name = "Loading Doors"; pixel_y = -8; pixel_x = 24},/obj/effect/turf_decal/stripes/line{dir = 4},/obj/effect/decal/cleanable/dirt,/turf/open/floor/iron/shuttle/cargo{dir = 1},/area/shuttle/supply)
"X" = (/obj/effect/turf_decal/stripes/line{dir = 4},/obj/effect/turf_decal/loading_area/white{dir = 4; pixel_x = -3},/turf/open/floor/iron/shuttle/cargo{dir = 1},/area/shuttle/supply)
"Y" = (/obj/machinery/conveyor{dir = 4; id = "cargoload"},/obj/machinery/door/poddoor{id = "cargoload"; name = "Supply Dock Loading Door"},/turf/open/floor/iron/dark/textured_large,/area/shuttle/supply)
"Z" = (/obj/effect/turf_decal/box/white/corners,/turf/open/floor/iron/dark/diagonal,/area/shuttle/supply)

(1,1,1) = {"
Cjjjjjp
Ktlmffj
jggfmar
jggmfWj
jTImfcS
jqffzsy
jzsfTIy
jggffXY
jggffbj
LTZfffO
HooHooH
HkkHkkH
"}
